DISCO (Deluxe) - Kylie Minogue
HEY WHAT - Low
Quivering In Time - Eris Drew
Dance Fever - Florence + The Machine
How Big, How Blue, How Beautiful (Deluxe) - Florence + The Machine
Everything Was Beautiful - Spiritualized
Exile On Main Street (2010 Re-Mastered) - The Rolling Stones
I Don’t Live Here Anymore - The War On Drugs
Meet The Humans - Steve Mason
Just For A Day - Slowdive
Their Satanic Majesties' Second Request - The Brian Jonestown Massacre
Fix Yourself, Not the World - The Wombats
The Album Paranoia - Ulrika Spacek
Why You so Crazy - The Dandy Warhols
Tafelmuzik Means More When You’re Alone - The Dandy Warhols
KID A MNESIA - Radiohead
This Is All Yours - alt-J
RELAXER - alt-J
Atlas - Real Estate
Handfuls of Night - Penguin Cafe
Somersault - Beach Fossils
Bathing Beach - Novo Amor
How Long Do You Think It's Gonna Last? - Big Red Machine
The Campfire Headphase - Boards of Canada
As The Love Continues - Mogwai
Ringthing - JAGUWAR
Their Satanic Majesties' Second Request - The Brian Jonestown Massacre
Land Between Rivers - Mythic Sunship
Upheaval - Mythic Sunship
Another Shape of Psychedelic Music - Mythic Sunship
Changing Shapes - Mythic Sunship
This Is Not A Safe Place - Ride
This Is The Place EP - Noel Gallagher's High Flying Birds
Honey Bones - DOPE LEMON
Universalis - Hammock
Departure Songs - Hammock
Clouds of Saint Marie - Ride
Waking Up In Another Town: Weather Diaries Remixed - Ride
Sleeping Operator - The Barr Brothers
Remix of Fools - Elephant Stone
Marble Skies - Django Django
Sunday in Bed, Vol. 6 (Sexy Sounds for Lazy Lovers) - Various Artists
No Tourists - The Prodigy
The Sick Bag Song (Unabridged) - Nick Cave
Echo Collective Plays Amnesiac - Echo Collective
Violence - Editors
Who Built The Moon? - Noel Gallagher's High Flying Birds
Rawville - The Bamboos
Shots 2 Shine - Esone
The Illectrik Hoax (A Monstrous Psychedelic Bubble Mix by the Amorphous Androgynous) - DJ Food
King Riff (AKA This Is Music) [Loco Studio Session / 2016 Remastered] - The Verve
Live at Roadburn - Papir